pos	Equipo	Puntos 	PJ 	Dif. de gol 	GF 	GC 
1	Brasil	45	17	34	39	5
2	Argentina	39	17	19	27	8
3	Uruguay	28	18	-1	21	22
4	Ecuador	26	18	8	27	19
5	Per√∫	24	18	-3	19	22
6	Colombia	23	18	1	20	19
7	Chile	19	18	-7	19	26
8	Paraguay	16	18	-14	12	26
9	Bolivia	15	18	-19	23	42
10	Venezuela	10	18	-20	14	34

